1666644424444344444443114444
4111144442411111444111441444
6664414554214344111443444144
4444144554214434433334444411
3344144224214443311116444444
4434142442214444177716444444
4443411444142221777716444422
4543422141244412777716444244
4543244411111144277144422244
4422331144244444421444244444
4244413444244554412442433444
2444164333424444144224344344
4444165543442441444444434433
7777165534424414666644443444
7774144344244441111114334777
4441443442443333434341444777
4414434424434444343434111111